Gobbledegook	Halandzsa
Lollygag	Henyel
Brouhaha	Felhajtas
Flabbergasted	Elkepedt
Kerfuffle	Zurzavar
Hullabaloo	Felhajtas
Catawampus	Ferden
Discombobulate	Osszezavar
Collywobbles	Gyomorideg
Gobbledygook	Halandzsa
Skedaddle	Elinal
Bamboozle	Raszed
Poppycock	Ostobasag
Nincompoop	Tokfej
Snollygoster	Onzo politikus
Widdershins	Oramutato jarasaval ellentetesen
Gubbins	Csacskasag
Rigmarole	Cirkalom
Whippersnapper	Szemtelen kolyok
Lickety-split	Villamgyorsan