Kuddelmuddel	Kaosz
Schnapsidee	Orult otlet
Fingerspitzengefuhl	Erzek
Treppenwitz	Lepcsovicc
Torschlusspanik	Zarasi panik
Fernweh	Tavolsagvagy
Kopfkino	Fejmozi
Kummerspeck	Banathaj
Backpfeifengesicht	Pofonert kialto arc
Schadenfreude	Karorom
Weltschmerz	Vilagfajdalom
Zugzwang	Kenyszerhelyzet
Sitzfleisch	Kitartas
Drachenfutter	Sarkanyeleseg
Ohrwurm	Fulferg
Fremdschamen	Mas szegyent erezni
Wanderlust	Vandorvagy
Schattenparker	Arnyekban parkolo
Kaffeeklatsch	Kavecsevej
Lebensmude	Eletunt