Sobremesa	Asztalnal beszelgetes
Friolero	Fazos
Madrugada	Hajnal
Empalagar	Eledesit
Desvelado	Almatlan
Antier	Tegnapelott
Merendar	Uzsonn√°zni
Estrenar	Eloszor hasznalni
Tocayo	Nevtars
Enmadrarse	Anyjahoz ragaszkodni
Verguenza ajena	Mas szegyent erezni
Despapaye	Zurzavar
Chapuza	Barkacsolas
Friolento	Fazos
Atolondrado	Kapkodo
Achuchar	Olelgetni
Mimoso	Dedelgeto
Desconchinflar	Osszetorni
Chiflado	Bolondos
Acojonante	Lenyugozo